Kobe_Bean_Bryant_(	August_23,_1978_)_is_an_American_former_professional_basketball_player.	born
Kobe_Bean_Bryant_(_born_August_23,_1978_)	an_American_former_professional_basketball_player.	is
He	his_entire_20-year_career_with_the_Los_Angeles_Lakers_of_the_National_Basketball_Association_(_NBA_).	played
He	the_NBA_directly_from_high_school_and_won_five_NBA_championships.	entered
He_entered_the_NBA_directly_from_high_school_and	five_NBA_championships.	won
Bryant	an_18-time_All_-_Star,_15-time_member_of_the_All_-_NBA_Team,_and_12-time_member_of_the_All_-_Defensive_team.	is
He	the_NBA_in_scoring_during_two_seasons_and_ranks_third_on_the_league's_all_-_time_regular_season_scoring_and_fourth_on_the_all_-_time_postseason_scoring_list.	led
He_led_the_NBA_in_scoring_during_two_seasons_and	third_on_the_league's_all_-_time_regular_season_scoring_and_fourth_on_the_all_-_time_postseason_scoring_list.	ranks
He_is_widely_regarded_as_one_of_the_greatest_basketball_players_of_all_time.[3][4][5][6_]_Bryant	the_first_guard_in_NBA_history_to_play_at_least_20_seasons.	is
He_is_widely_regarded_as_one_of_the_greatest_basketball_players_of_all_time.[3][4][5][6_]_Bryant_is_the_first_guard_in_NBA_history	at_least_20_seasons.	to_play
Bryant	the_son_of_former_NBA_player_Joe_Bryant.	is
He	a_successful_high_school_basketball_career_at_Lower_Merion_High_School_in_Pennsylvania,_where_he_was_recognized_as_the_top_high_school_basketball_player_in_the_country.	enjoyed
He_enjoyed_a_successful_high_school_basketball_career_at_Lower_Merion_High_School_in_Pennsylvania,_where_he	as_the_top_high_school_basketball_player_in_the_country.	was_recognized
Upon_graduation,_he	for_the_NBA_draft_and_was_selected_by_the_Charlotte_Hornets_in_the_13th_overall_pick_in_the_1996_NBA_draft.	declared
Upon_graduation,_he_declared_for_the_NBA	by_the_Charlotte_Hornets_in_the_13th_overall_pick_in_the_1996_NBA_draft.	draft_and_was_selected
Upon_graduation,_he_declared_for_the_NBA_draft_and_was_selected_by_the_Charlotte_Hornets_in_the_13th_overall	in_the_1996_NBA_draft.	pick
The_Hornets_then	him_to_the_Lakers.	traded
As_a_rookie,_Bryant	himself_a_reputation_as_a_high_-_flyer_and_a_fan_favorite_by_winning_the_1997_Slam_Dunk_Contest,_and_he_was_named_an_All_-_Star_by_his_second_season.	earned
As_a_rookie,_Bryant_earned_himself_a_reputation_as_a_high_-_flyer_and_a_fan_favorite	the_1997_Slam_Dunk_Contest,_and_he_was_named_an_All_-_Star_by_his_second_season.	by_winning
As_a_rookie,_Bryant_earned_himself_a_reputation_as_a_high_-_flyer_and_a_fan_favorite_by_winning_the_1997_Slam_Dunk_Contest,_and_he	an_All_-_Star_by_his_second_season.	was_named
Despite_a_feud_between_the_two_players,_Bryant_and_Shaquille_O'Neal	the_Lakers_to_three_consecutive_NBA_championships_from_2000_to_2002.	led
In_2003,_Bryant_was_accused_of_sexual_assault,_but_the_charges_were_eventually_dropped,_and_a_civil_suit	out_of_court.	was_settled
In_2003,_Bryant_was_accused_of_sexual_assault,_but_the_charges	eventually_dropped,_and_a_civil_suit_was_settled_out_of_court.	were
In_2003,_Bryant_was_accused_of_sexual_assault,_but_the_charges_were_eventually	,_and_a_civil_suit_was_settled_out_of_court.	dropped
After_the_Lakers	the_2004_NBA_Finals,_O'Neal_was_traded_to_the_Miami_Heat_and_Bryant_became_the_cornerstone_of_the_Lakers.	lost
After_the_Lakers_lost_the_2004_NBA_Finals,_O'Neal	to_the_Miami_Heat_and_Bryant_became_the_cornerstone_of_the_Lakers.	was_traded
After_the_Lakers_lost_the_2004_NBA_Finals,_O'Neal_was_traded_to_the_Miami_Heat_and_Bryant	the_cornerstone_of_the_Lakers.	became
He	the_NBA_in_scoring_during_the_2005–06_and_2006–07_seasons.	led
In_2006,_he_scored_a_career_-_high_81_points_against_the_Toronto_Raptors,_the_second_most_points	in_a_single_game_in_league_history_behind_Wilt_Chamberlain's_100-point_game_in_1962.	scored
Bryant	the_regular_season's_Most_Valuable_Player_Award_(_MVP_)_in_2008.	was_awarded
After	in_the_2008_NBA_Finals,_he_led_the_Lakers_to_two_consecutive_championships_in_2009_and_2010,_earning_the_Finals_MVP_Award_on_both_occasions.	losing
After_losing_in_the_2008_NBA_Finals,_he	the_Lakers_to_two_consecutive_championships_in_2009_and_2010,_earning_the_Finals_MVP_Award_on_both_occasions.	led
After_losing_in_the_2008_NBA_Finals,_he_led_the_Lakers_to_two_consecutive_championships_in_2009_and_2010,	the_Finals_MVP_Award_on_both_occasions.	earning
He	among_the_top_players_in_the_league_through_2013_until_he_suffered_a_torn_Achilles_tendon_at_age_34.	continued_to_be
He_continued_to_be_among_the_top_players_in_the_league_through_2013_until_he	a_torn_Achilles_tendon_at_age_34.	suffered
He_continued_to_be_among_the_top_players_in_the_league_through_2013_until_he_suffered_a_torn_Achilles	at_age_34.	tendon
Although_he_recovered,_his_play	the_following_two_years_by_season_-_ending_injuries_to_his_knee_and_shoulder,_respectively.	was_limited
Although_he_recovered,_his_play_was_limited_the_following_two_years_by_season_-	injuries_to_his_knee_and_shoulder,_respectively.	ending
Citing_his_physical_decline,_he	that_he_would_retire_after_the_2015–16_season.	announced
Citing_his_physical_decline,_he_announced_that_he	after_the_2015–16_season.	would_retire
At_34_years_and_104_days_of_age,_Bryant	the_youngest_player_in_league_history_to_reach_30,000_career_points.	became
At_34_years_and_104_days_of_age,_Bryant_became_the_youngest_player_in_league_history	30,000_career_points.	to_reach
He	the_all_-_time_leading_scorer_in_Lakers_franchise_history_on_February_1,_2010,_when_he_surpassed_Jerry_West.	became
He_became_the_all_-_time	scorer_in_Lakers_franchise_history_on_February_1,_2010,_when_he_surpassed_Jerry_West.	leading
He_became_the_all_-_time_leading_scorer_in_Lakers_franchise_history_on_February_1,_2010,_when_he	Jerry_West.	surpassed
During_his_third_year_in_the_league,_Bryant	to_start_the_All_-_Star_Game,_and_he_would_continue_to_be_selected_to_start_that_game_for_a_record_18_consecutive_appearances_until_his_retirement.	was_chosen
During_his_third_year_in_the_league,_Bryant_was_chosen_to_start_the_All_-_Star_Game,_and_he_would_continue_to_be_selected	that_game_for_a_record_18_consecutive_appearances_until_his_retirement.	to_start
During_his_third_year_in_the_league,_Bryant_was_chosen_to_start_the_All_-_Star_Game,_and	to_start_that_game_for_a_record_18_consecutive_appearances_until_his_retirement.	he_would_continue_to_be_selected
His_four_All_-_Star_MVP_Awards	for_the_most_in_NBA_history.	are_tied
At_the_2008_and_2012_Summer_Olympics,_he	gold_medals_as_a_member_of_the_U.S._national_team.	won
In_2018,_Bryant	the_Academy_Award_for_Best_Animated_Short_Film_for_his_film_Dear_Basketball.[7_]	won
