Avengers_:_Endgame	widely_anticipated,_and_Disney_backed_the_film_with_extensive_marketing_campaigns.	was
Avengers_:_Endgame_[BV:_was_widely]	,_and_Disney_backed_the_film_with_extensive_marketing_campaigns.	anticipated
Avengers_:_Endgame_was_widely_anticipated,_and_Disney	the_film_with_extensive_marketing_campaigns.	backed
It	in_Los_Angeles_on_April_22,_2019,_and_was_theatrically_released_in_the_United_States_on_April_26,_2019,_in_IMAX_and_3D.	premiered
It_premiered_in_Los_Angeles_on_April_22,_2019,_and	theatrically_released_in_the_United_States_on_April_26,_2019,_in_IMAX_and_3D.	was
It_premiered_in_Los_Angeles_on_April_22,_2019,_and_[BV:_was_theatrically]	in_the_United_States_on_April_26,_2019,_in_IMAX_and_3D.	released
The_film	praise_for_its_direction,_acting,_entertainment_value,_and_emotional_weight,_with_critics_lauding_its_culmination_of_the_22-film_story.	received
The_film_received_praise_for_its_direction,_acting,_entertainment_value,_and_emotional_weight,_with_critics	its_culmination_of_the_22-film_story.	lauding
It_also	numerous_box_office_records_and_has_grossed_over_$_1.2_billion_worldwide,_becoming_the_highest_-_grossing_film_of_2019,_as_well_as_the_18th_-_highest_-_grossing_film_of_all_time.	broke
It_also_broke_numerous_box_office_records_and_[BV:_has]	over_$_1.2_billion_worldwide,_becoming_the_highest_-_grossing_film_of_2019,_as_well_as_the_18th_-_highest_-_grossing_film_of_all_time.	grossed
It_also_broke_numerous_box_office_records_and_has_grossed_over_$_1.2_billion_worldwide,	the_highest_-_grossing_film_of_2019,_as_well_as_the_18th_-_highest_-_grossing_film_of_all_time.	becoming
It_also_broke_numerous_box_office_records_and_has_grossed_over_$_1.2_billion_worldwide,_becoming_the_highest_-_grossing_film_of_2019,_as_well_as_the_18th_-_highest_-	film_of_all_time.	grossing
The_film_[BV:_was]	in_October_2014_as_Avengers_:_Infinity_War_â€“_Part_2.	announced
The_Russo_brothers	on_board_to_direct_in_April_2015,_and_by_May,_Markus_and_McFeely_signed_on_to_script_the_film.	came
The_Russo_brothers_came_on_board_[BV:_to]	in_April_2015,_and_by_May,_Markus_and_McFeely_signed_on_to_script_the_film.	direct
The_Russo_brothers_came_on_board_to_direct_in_April_2015,_and_by_May,_Markus_and_McFeely	on_to_script_the_film.	signed
The_Russo_brothers_came_on_board_to_direct_in_April_2015,_and_by_May,_Markus_and_McFeely_[BV:_signed_on_to]	the_film.	script
In_July_2016,_Marvel	the_title,_referring_to_it_simply_as_Untitled_Avengers_film.	removed
In_July_2016,_Marvel_removed_the_title,	to_it_simply_as_Untitled_Avengers_film.	referring
Additional_filming	place_in_the_Metro_and_Downtown_Atlanta_areas_and_New_York.	took
The_official_title_[BV:_was]	in_December_2018.	revealed
Avengers_:_Endgame	a_2019_American_superhero_film_based_on_the_Marvel_Comics_superhero_team_the_Avengers,_produced_by_Marvel_Studios_and_distributed_by_Walt_Disney_Studios_Motion_Pictures.	is
Avengers_:_Endgame_is_a_2019_American_superhero_film	on_the_Marvel_Comics_superhero_team_the_Avengers,_produced_by_Marvel_Studios_and_distributed_by_Walt_Disney_Studios_Motion_Pictures.	based
Avengers_:_Endgame_is_a_2019_American_superhero_film_based_on_the_Marvel_Comics_superhero_team_the_Avengers,	by_Marvel_Studios_and_distributed_by_Walt_Disney_Studios_Motion_Pictures.	produced
It	the_sequel_to_2012's_The_Avengers,_2015's_Avengers_:_Age_of_Ultron_and_2018's_Avengers_:_Infinity_War,_and_the_22nd_film_in_the_Marvel_Cinematic_Universe_(_MCU_).	is
The_film_[BV:_is]	by_Anthony_and_Joe_Russo,_written_by_Christopher_Markus_and_Stephen_McFeely_and_features_an_ensemble_cast_including_Robert_Downey_Jr.,_Chris_Evans,_Mark_Ruffalo,_Chris_Hemsworth,_Scarlett_Johansson,_Jeremy_Renner,_Don_Cheadle,_Paul_Rudd,_Brie_Larson,_Karen_Gillan,_Danai_Gurira,_Bradley_Cooper,_and_Josh_Brolin.	directed
The_film_is_directed_by_Anthony_and_Joe_Russo,	by_Christopher_Markus_and_Stephen_McFeely_and_features_an_ensemble_cast_including_Robert_Downey_Jr.,_Chris_Evans,_Mark_Ruffalo,_Chris_Hemsworth,_Scarlett_Johansson,_Jeremy_Renner,_Don_Cheadle,_Paul_Rudd,_Brie_Larson,_Karen_Gillan,_Danai_Gurira,_Bradley_Cooper,_and_Josh_Brolin.	written
The_film_is_directed_by_Anthony_and_Joe_Russo,_written_by_Christopher_Markus_and_Stephen_McFeely_and	an_ensemble_cast_including_Robert_Downey_Jr.,_Chris_Evans,_Mark_Ruffalo,_Chris_Hemsworth,_Scarlett_Johansson,_Jeremy_Renner,_Don_Cheadle,_Paul_Rudd,_Brie_Larson,_Karen_Gillan,_Danai_Gurira,_Bradley_Cooper,_and_Josh_Brolin.	features
The_film_is_directed_by_Anthony_and_Joe_Russo,_written_by_Christopher_Markus_and_Stephen_McFeely_and_features_an_[BV:_ensemble_cast]	Robert_Downey_Jr.,_Chris_Evans,_Mark_Ruffalo,_Chris_Hemsworth,_Scarlett_Johansson,_Jeremy_Renner,_Don_Cheadle,_Paul_Rudd,_Brie_Larson,_Karen_Gillan,_Danai_Gurira,_Bradley_Cooper,_and_Josh_Brolin.	including
In_the_film,_the	members_of_the_Avengers_and_their_allies_work_to_reverse_the_damage_caused_by_Thanos_in_Infinity_War.	surviving
In_the_film,_the_surviving_members_of_the_Avengers_and_their_allies	to_reverse_the_damage_caused_by_Thanos_in_Infinity_War.	work
In_the_film,_the_surviving_members_of_the_Avengers_and_their_allies_work_[BV:_to]	the_damage_caused_by_Thanos_in_Infinity_War.	reverse
In_the_film,_the_surviving_members_of_the_Avengers_and_their_allies_work_to_reverse_the_damage	by_Thanos_in_Infinity_War.	caused
